"aI" = (/obj/machinery/chem_dispenser/beer/upgraded,/obj/structure/table/wood/poker,/turf/unsimulated/floor{dir = 8; icon = 'icons/turf/floors/carpet_black.dmi'; icon_state = "carpet"},/area/adminconstruction)
"aR" = (/obj/structure/flora/tree/pine,/turf/unsimulated/floor/snow,/area/adminconstruction)
"bj" = (/obj/effect/step_trigger/teleporter{icon = 'icons/mob/screen_gen.dmi'; icon_state = "x3"; teleport_x = 111; teleport_y = 209; teleport_z = 2},/obj/effect/turf_decal{color = "red"; icon = 'icons/obj/objects.dmi'; icon_state = "anom"; name = "anomaly_decal"},/turf/unsimulated/floor/snow,/area/adminconstruction)
"cE" = (/turf/unsimulated/floor/snow,/area/adminconstruction)
"cK" = (/obj/structure/closet/crate/freezer,/obj/item/clothing/suit/space/santa,/obj/item/clothing/head/helmet/space/santahat,/obj/item/gun/energy/pulse/destroyer,/obj/item/paper{info = "Доберитесь до конца арены быстрее команды своих противников!"},/obj/item/clothing/shoes/jackboots,/obj/item/shield/energy,/obj/item/clothing/under/tourist_suit,/turf/unsimulated/floor{icon_state = "darkgrey"},/area/adminconstruction)
"dd" = (/turf/unsimulated/wall{icon = 'icons/turf/walls/silver_wall.dmi'; icon_state = "silver"},/area/adminconstruction)
"dq" = (/obj/machinery/mass_driver/bumper{dir = 4; icon = 'icons/effects/clockwork_effects.dmi'; icon_state = "servant_blocker"; name = "Speed Up"},/turf/unsimulated/floor/snow{icon_state = "ice"; name = "ice"},/area/adminconstruction)
"gh" = (/obj/structure/barricade/wooden/crude/snow,/turf/unsimulated/floor/snow,/area/adminconstruction)
"gs" = (/obj/effect/turf_decal/arrows/red{dir = 1},/turf/unsimulated/floor/snow,/area/adminconstruction)
"gt" = (/obj/machinery/vending/coffee,/turf/unsimulated/floor{dir = 8; icon = 'icons/turf/floors/carpet_black.dmi'; icon_state = "carpet"},/area/adminconstruction)
"gS" = (/obj/structure/mirror/magic{pixel_y = -30},/mob/living/carbon/human,/turf/unsimulated/floor{icon_state = "darkgrey"},/area/adminconstruction)
"ht" = (/obj/structure/table/wood/poker,/obj/item/paper{info = "150, 213, 2"; name = "Координаты для спавна"},/turf/unsimulated/floor{dir = 8; icon = 'icons/turf/floors/carpet_black.dmi'; icon_state = "carpet"},/area/adminconstruction)
"iq" = (/obj/machinery/disco/immobile{active = 1; stop = 99999999},/turf/unsimulated/wall{icon = 'icons/turf/walls/silver_wall.dmi'; icon_state = "silver"},/area/adminconstruction)
"ks" = (/obj/machinery/door_control{id = "start_game"; name = "Start game"},/turf/unsimulated/wall{icon = 'icons/turf/walls/silver_wall.dmi'; icon_state = "silver"},/area/adminconstruction)
"kE" = (/turf/unsimulated/floor/snow{icon_state = "snow-ice"; name = "Icy Window"},/area/adminconstruction)
"lg" = (/obj/machinery/mass_driver/bumper{icon = 'icons/effects/clockwork_effects.dmi'; icon_state = "servant_blocker"; name = "Speed Up"},/turf/unsimulated/floor/snow{icon_state = "ice"; name = "ice"},/area/adminconstruction)
"lo" = (/obj/effect/mine/pickup/healing,/turf/unsimulated/floor/snow,/area/adminconstruction)
"mo" = (/obj/structure/chair/comfy/brown,/turf/unsimulated/floor{dir = 8; icon = 'icons/turf/floors/carpet_black.dmi'; icon_state = "carpet"},/area/adminconstruction)
"oM" = (/obj/machinery/mass_driver/bumper{dir = 1; icon = 'icons/effects/clockwork_effects.dmi'; icon_state = "servant_blocker"; name = "Speed Up"},/turf/unsimulated/floor/snow{icon_state = "ice"; name = "ice"},/area/adminconstruction)
"pe" = (/obj/structure/table/wood/poker,/obj/item/toy/cards/deck/syndicate/black,/turf/unsimulated/floor{dir = 8; icon = 'icons/turf/floors/carpet_black.dmi'; icon_state = "carpet"},/area/adminconstruction)
"pG" = (/obj/machinery/mass_driver/bumper{dir = 8; icon = 'icons/effects/clockwork_effects.dmi'; icon_state = "servant_blocker"; name = "Speed Up"},/turf/unsimulated/floor/snow{icon_state = "ice"; name = "ice"},/area/adminconstruction)
"qc" = (/obj/structure/barricade/wooden/crude/snow,/obj/structure/barricade/wooden/crude/snow,/turf/unsimulated/floor/snow,/area/adminconstruction)
"un" = (/obj/structure/flora/tree/dead,/turf/unsimulated/floor/snow,/area/adminconstruction)
"uU" = (/obj/structure/table/wood/poker,/turf/unsimulated/floor{dir = 8; icon = 'icons/turf/floors/carpet_black.dmi'; icon_state = "carpet"},/area/adminconstruction)
"vF" = (/obj/machinery/vending/snack,/turf/unsimulated/floor{dir = 8; icon = 'icons/turf/floors/carpet_black.dmi'; icon_state = "carpet"},/area/adminconstruction)
"vU" = (/obj/effect/step_trigger/teleporter{icon = 'icons/mob/screen_gen.dmi'; icon_state = "x3"; teleport_x = 111; teleport_y = 211; teleport_z = 2},/obj/effect/turf_decal{color = "red"; icon = 'icons/obj/objects.dmi'; icon_state = "anom"; name = "anomaly_decal"},/turf/unsimulated/floor/snow,/area/adminconstruction)
"wD" = (/obj/effect/turf_decal{color = "red"; icon = 'icons/obj/objects.dmi'; icon_state = "anom"; name = "anomaly_decal"},/obj/effect/step_trigger/teleporter{icon = 'icons/mob/screen_gen.dmi'; icon_state = "x3"; teleport_x = 175; teleport_y = 227; teleport_z = 2},/turf/unsimulated/floor/snow,/area/adminconstruction)
"wY" = (/obj/vehicle/space/speedbike/red{dir = 4},/turf/unsimulated/floor{icon_state = "darkgrey"},/area/adminconstruction)
"Al" = (/obj/effect/mine/sound/bwoink,/turf/unsimulated/floor/snow,/area/adminconstruction)
"AK" = (/obj/structure/chair/comfy/brown{dir = 8},/turf/unsimulated/floor{dir = 8; icon = 'icons/turf/floors/carpet_black.dmi'; icon_state = "carpet"},/area/adminconstruction)
"CB" = (/obj/item/clothing/head/snowman,/obj/item/clothing/suit/snowman,/obj/structure/closet/crate/freezer,/obj/item/gun/energy/pulse/destroyer,/obj/item/paper{info = "Доберитесь до конца арены быстрее команды своих противников!"},/obj/item/clothing/shoes/clown_shoes,/obj/item/shield/energy,/obj/item/clothing/under/tourist_suit,/turf/unsimulated/floor{icon_state = "darkgrey"},/area/adminconstruction)
"CC" = (/obj/item/twohanded/required/kirbyplants,/turf/unsimulated/floor{dir = 8; icon = 'icons/turf/floors/carpet_black.dmi'; icon_state = "carpet"},/area/adminconstruction)
"CO" = (/turf/unsimulated/wall/fakeglass{icon = 'icons/turf/snow.dmi'; icon_state = "snow-ice"; name = "Icy Window"; tag = "icon-fakewindows (EAST)"},/area/adminconstruction)
"EN" = (/obj/machinery/vending/cigarette{prices = list()},/turf/unsimulated/floor{dir = 8; icon = 'icons/turf/floors/carpet_black.dmi'; icon_state = "carpet"},/area/adminconstruction)
"FC" = (/obj/effect/mine/explosive,/turf/unsimulated/floor/snow,/area/adminconstruction)
"Gl" = (/turf/unsimulated/floor{dir = 8; icon = 'icons/turf/floors/carpet_black.dmi'; icon_state = "carpet"},/area/adminconstruction)
"Iy" = (/obj/structure/mirror/magic{pixel_y = 30},/mob/living/carbon/human,/turf/unsimulated/floor{icon_state = "darkgrey"},/area/adminconstruction)
"IE" = (/obj/effect/turf_decal{color = "red"; icon = 'icons/obj/objects.dmi'; icon_state = "anom"; name = "anomaly_decal"},/obj/effect/step_trigger/teleporter{icon = 'icons/mob/screen_gen.dmi'; icon_state = "x3"; teleport_x = 112; teleport_y = 224; teleport_z = 2},/turf/unsimulated/floor/snow,/area/adminconstruction)
"MH" = (/obj/machinery/mass_driver/bumper{dir = 1; icon = 'icons/effects/clockwork_effects.dmi'; icon_state = "servant_blocker"; name = "Speed Up"},/obj/effect/turf_decal/box/white{color = "blue"},/turf/unsimulated/floor/snow{icon_state = "ice"; name = "ice"},/area/adminconstruction)
"Nd" = (/obj/effect/step_trigger/teleporter{icon = 'icons/mob/screen_gen.dmi'; icon_state = "x3"; teleport_x = 168; teleport_y = 247; teleport_z = 2},/obj/effect/turf_decal{color = "red"; icon = 'icons/obj/objects.dmi'; icon_state = "anom"; name = "anomaly_decal"},/turf/unsimulated/floor/snow,/area/adminconstruction)
"Pb" = (/turf/unsimulated/floor/snow{icon = 'icons/turf/walls/silver_wall.dmi'; icon_state = "silver"; name = "Wall"},/area/adminconstruction)
"Pd" = (/obj/structure/barricade/wooden/crude/snow,/obj/effect/mine/stun,/turf/unsimulated/floor/snow,/area/adminconstruction)
"Po" = (/mob/living/simple_animal/hostile/tree,/turf/unsimulated/floor/snow,/area/adminconstruction)
"Pq" = (/obj/effect/turf_decal/weather/snow/corner{dir = 4},/turf/unsimulated/floor{dir = 4; icon_state = "darkgreycamo"},/area/adminconstruction)
"QA" = (/obj/machinery/door/poddoor{id_tag = "start_game"},/turf/unsimulated/floor{dir = 8; icon_state = "darkgreycamo"},/area/adminconstruction)
"QO" = (/obj/structure/barricade/wooden/crude/snow,/obj/effect/mine/explosive,/turf/unsimulated/floor/snow,/area/adminconstruction)
"Us" = (/obj/machinery/vending/boozeomat{req_access_txt = null},/turf/unsimulated/floor{dir = 8; icon = 'icons/turf/floors/carpet_black.dmi'; icon_state = "carpet"},/area/adminconstruction)
"UW" = (/obj/effect/mine/stun,/turf/unsimulated/floor/snow,/area/adminconstruction)
"Wc" = (/turf/simulated/floor/chasm/straight_down/lava_land_surface,/area/adminconstruction)
"XN" = (/obj/effect/turf_decal/weather/snow/corner{dir = 8},/turf/unsimulated/floor{icon_state = "darkgrey"},/area/adminconstruction)
"Yy" = (/turf/unsimulated/floor{icon_state = "darkgrey"},/area/adminconstruction)
"YK" = (/obj/vehicle/space/speedbike{dir = 4},/turf/unsimulated/floor{icon_state = "darkgrey"},/area/adminconstruction)
"Zy" = (/obj/machinery/chem_dispenser/soda/upgraded,/obj/structure/table/wood/poker,/turf/unsimulated/floor{dir = 8; icon = 'icons/turf/floors/carpet_black.dmi'; icon_state = "carpet"},/area/adminconstruction)

(1,1,1) = {"
dddddddddddddddddddddddddddddddddddddddddddddddddddddddddddddddddddddddddddddddddddddddddddddddddddddddddddddddddddddddddddddddddddddddddddddddddddddddddddddddd
ddIyIyIyYyYyPqQAXNcEYyddddddddddddcEghcEcEcEcEcEcEghcEcEghcEcEcEghcEcEcEcEcEcEdqdqdqdqdqdqcEcEcEcEcEcEcEcEghcEcEcEcEcEghcEcEcEghcEcEcEcEcECOCOUsGlaIZyCCmomoCCdd
ddYyYyYyYKYyPqQAXNYycEcEddddddddcEcEghcEcEaRcEcEcEghghcEcEcEcEcEcEcEghcEcEcEcEdqdqdqdqdqdqcEcEcEcEcEcEcEcEcEcEaRcEcEcEghcEcEcEcEcEcEcEcEcEcECOCOGlGlGlGluUpeAKdd
ddYyYyYyYKYyPqQAXNcEYyYyghddddcEcEcEcEcEcEcEghcEcEghghcEcEghcEcEghcEcEcEcEghcEcEcEcEcEcEcEcEcEcEcEunghcEcEcEcEcEcEcEcEcEcEcEcEghcEcEcEcEaRcEcECOCOGlGlGlhtuUAKdd
ddYyYyYyYKYyPqQAXNYycEYycEcEcEcEuncEcEghcEcEghcEcEghcEcEcEcEcEcEcEcEcEcEcEcEcEcEcEcEghcEcEcEcEcEcEcEcEcEcEcEcEdqdqdqdqdqdqcEcEcEcEcEcEcEcEghcEcECOCOGlGlGlGlCCdd
ddCBCBCBYyYyPqQAXNcEYycEYycEcEcEcEcEcEghcEcEcEcEcEghghcEuncEcEghcEcEcEaRcEcEghcEcEcEcEcEcEghcEghcEcEcEghcEcEcEdqdqdqdqdqdqcEcEcEcEcEcEcEcEghcEcEcECOCOGlGlGlvFdd
ddddddddCOCOddiqkscEcEcEcEcEcEcEddddddddddddddddddddddddddddddddddddddddddddddddddddddddddddddddddddddddddddddddddddddddddddddddddcEcEghcEcEcEcEcEghCOCOGlGlENdd
ddcKcKcKYyYyPqQAXNcEcEYycEcEcEddddcEcEcEcEWcWcWcWcWcWcWcWcWcghghcEcEIEWcWcWcghcEcEcEcEcEpGpGpGpGpGpGcEcEghghcEcEcEcEcEcEcEghcEcEddddcEcEcEcEcEcEcEghghCOCOGlGldd
ddYyYyYywYYyPqQAXNcEYycEcEghddddcEcEcEghcEcEWcWcWcWcWcWcWcghghghcEWcWcWcWcWcghcEcEcEcEcEpGpGpGpGpGpGcEcEcEghcEcEcEcEghcEcEghcEuncEddddcEcEcEcEcEghghcEcECOCOgtdd
ddYyYyYywYYyPqQAXNYycEcEcEddddcEcEcEcEcEghcEghWcWcWcWccEcElocEghWcWcWcWcWccEcEcEcEcEcEcEcEcEcEcEcEuncEcEcEghcEcEghcEcEcEcEghcEcEghcEddddcEcEcEcEcEghcEghghCOCOdd
ddYyYyYywYYyPqQAXNcEYycEddddcEcEcEcEcEcEcEcEghcEWcWcghghcEcEcEWcWcWcWccEcEcEcEcEghcEcEaRcEcEcEcEcEcEcEcEcEcEcEunghcEcElocEcEcEghghcEghddddcEPocEcEcEcEcEcEghCOdd
ddgSgSgSYyYyPqQAXNcEYyddddcEcEcEaRcEcEcEWccEcEcEcEcEcEghghWcWcWcWcWcghcEcEcEWcWcWccEcEcEcEcEddddddddddddddddddddddddddcEcEcEcEghghghcEcEddddghghcEcEcEghghghcEdd
ddddddddddddddddddddddddcEcEghghcEcEcEWcWcWccEcEghcEcEWcWcWcWcWcghghcEcEcEWcWcWcghcEcENdddddddcEcEcEcEghcEcEcEcEcEcEddddcEcEcEghghghghcEcEddddghghcEcEcEghcEcEdd
ddddddddddddddddddddddddcEcEcEghghcEWcWcWcWccEghcEcEWcWcWcWcWcghcEcEcEunWcWcWcghcEcEddddddcEcEcEghcEcEcEWcWccEcEghcEcEddddaRcEcEghghghcEcEcEddddghcEcEcEcEcEundd
ddddddddddddddddddddddghcEcEcEcEghWcWcWcWccEcEcEcEWcWcWcWcWccEghcEghWcWcWcWccEcEcEddddWcWcWccEcEcEcEcEcEWcWcWccEcEcEcEcEddcEcEcEghghghcEghcEcEddddcEcEcEcEghghdd
ddddddddddddddddddddcEcEghcEcEWcWcWcWcWccEcEcEcEWcWcWcWcghcEcEcEcEWcWcWcWccEcEcEddddcEcEWcWcWccEghcEaRcEcEWcWcWccEghcEcEddcEcEcEghghcEcEghcEcEcEddddghghcEcEcEdd
ddddddddddddddddddcEcEcEcEcEWcWcWcWcWccEcEghcEcEcEcEWccEcEPocEcEWcWcWcWccEcEghddddcEcEcEcEWcWcWcWccEcEcEcEcEWcWccEcEcEcEddddghcEghqccEcEghcEcEcEghcEcEcEcEghghdd
ddddddddddddddddcEcEcEghcEWcWcWcWcWcghcEcEcEcEcEcEcEcEcEcEcEghWcWcWcWcghcEcEddddcEcEcEcEghcEWcWcWcWccEghcEcEWcWcWccEcEghcEddcEcEghghcEcEcEcEghghghcElocEghghcEdd
ddddddddddddddghcElocEghWcWcWcWcWccEcEcEcEWcWcuncEghcEghcEWcWcWcWcWccEcEcEddddcEcEWcWccEcEcEcEWcWcWcWccEcEcEWcWcWccEghcEcEddddcEcEghcEPocEcEcEghcEcEcEcEghcEcEdd
ddddddddddddcEcEcEcEcEcEWcWcWcWcghcEcEcEWcWcWcWccEcEcEWcWcWcWcWcWcuncEghddddcEcEcEWcWcWccEcEghWcWcWcWccEcEcEWcWcWccEcEcEcEcEddghghghcEghcEcEcEghghcEcEcEcEcEcEdd
ddddddddddcEcEcEcEcEghWcWcWcWccEcEcEghWcWcWcWcWcWcWcWcWcWcWcWcghcEcEcEddddcEcEcEcEWcWcWcWccEcEcEWcWcWccEghcEghWcWcWccEcEghcEddddghghcEcEcEghcEghcEcEghcEcEcEcEdd
ddddddddcEcEcEuncEcEWcWcWcWccEcEcEcEWcWcWcWcWcWcWcWcWcWcWcWccEcEcEghddddcEloaRcEcEcEWcWcWcWccEghcEcEcEghcEcEcEWcWcWcWcghcEcEghddddddddcEghghcEghcEghcEghcEPocEdd
ddddddcEcEcEWcWccEcEWcWcWcuncEcEcEcEWcWcWcWcWcWcWcWcWcWcghcEcEcEcEddddcEcEcEcEcEcEcEunWcWcWccEcEcEghcEcEcEcEcEghWcWcWccEcEcEghghghghddddddghcEcEcEghcEcEcEcEcEdd
ddddcEcEcEWcWcWccEcEWcWcWccEcEaRcEcEWcWcWcWcWcWcWcghcEcEghcEcEghddddddddddddddddddddddddddddPbPbddddddddPbPbddddddddddddddddddddghghcEcEddddddcEcEcEcEcEuncEdddd
ddghcEcEghWcWcWccEcEcEWcWcWccEcEcEcEcEWcWcWcWccEcEcEcEcEcEcEddddddddcEcEcEcEcEddcEcEcEcEcEddcEcEcEcEcEddcEcEcEcEcEddcEcEcEcEcEddcEcEcEghdddddddddddddddddddddddd
ddcEcEcEWcWcWcWcWccEcEcEWcWcWccEcEghcEloghcEcEcEcEcEghcEddddddcEcEddcEcEcEcEcEddcEcEcEcEcEddcEcEcEcEcEddcEcEcEcEcEddcEcEcEcEcEddcEUWcEghcEcEcEcEghcEcEcEcEcEcEdd
ddghghcEWcWcWcWcWcghcEcEWcWcWcWcghghcEcEghcEcEcEghcEddddddghcEcEcEddoMoMddghcEddoMoMddcEghddoMoMddghghddoMoMddcEghddoMoMddghcEddcEcEcEcEcEghcEcEghcEUWcEghcEghdd
ddcEcEcEWcWcWcWcWcWccEcEcEWcWcWcWcWccEcEcEcEunddddddddcEghghcEcEcEddoMoMddghghddoMoMddghghddoMoMddghghddoMoMddghghddoMoMddghghddcEcEghcEUWcEghcEcEcEcEghcEcEcEdd
ddcEcEcEWcWcWcWcWcWccEcEghghWcWcWcWcWcddddddddddcEcEcEcEghcEcEghcEddoMoMddghghddoMoMddcEghddoMoMddghPoddoMoMddghghddoMoMddghghddddddddddddddddddddddddddddcEcEdd
ddcEcEcEghWcWcWcWcghcEghcEcEcEddddddddddcEcEcEghcEcEcEcEghcEcEghghddoMoMddghghddoMoMddghghddoMoMddghghddoMoMddghghddoMoMddunghddghghcEcEcEcEghcEcEcEghghddcEcEdd
ddcEcEghcEcEWcWccEcEcEcEcEcEddddcEcEcEcEcEcEcEghcEghcEcEcEcEcEcEcEddoMoMddghghddoMoMddghghddoMoMddghghddoMoMddghghddoMoMddghghddghUWcEghghghddddddcEUWghddghcEdd
ddghcEcEcEcEcEcEcEcEcEcEcEddddghcEghcEcEghcEcEcEcEghcEghghcEcEcEcEddoMoMddghghddoMoMddghghddoMoMddghghddoMoMddghghddoMoMddghghddcEcEcEUWghddddghcEcEcEcEddcEUWdd
ddcEcEcEcEcEcEcEcEcEcEcEddddcEcEcEghcEcEghddddddddddddddddddddlglgddoMoMddghunddoMoMddghghddoMoMddghghddoMoMddghghddoMoMddghghddUWcEcEcEddddghghghcEUWcEddcEghdd
ddghghghghcEcEuncEcEghddddghcEcEghddddddddddAlAlAlAlAlAlAlAlddlglgddoMoMddghghddoMoMddghghddoMoMddghghddoMoMddghghddoMoMddghghddghcEUWddddghcEcEcEcEcEghddcEcEdd
ddddghghghcEcEghcEcEddddcEcEcEcEddddAlAlAlAlAlddAlddAlddAlAlddlglgddoMoMddghghddoMoMddghghddoMoMddghghddoMoMddghghddoMoMddghghddcEcEghddcEcEFCuncEghghddddqcghdd
ddddddghghghcEghcEghddcEcEcEcEddddAlAlAlAlAlAlAlAlAlAlAlAlAlddlglgddoMoMddghghddoMoMddghghddoMoMddghghddoMoMddghghddoMoMddghghddcEghghddPdghcEUWghghddddUWcEcEdd
ddddddddghghghghghghddcEghghddddAlAlAlddddddddddddddAlAlddAlddlglgddoMoMddghcEddoMoMddghghddoMoMddghghddoMoMddghghddoMoMddghghddcEcEcEddcEUWcEcEghddddcEghcEcEdd
ddddddddddcEghghghloddghcEcEddAlAlAlddddAlAlAlAlAlddAlAlAlAlddlglgddoMoMddghcEddoMoMddghghddoMoMddunghddoMoMddghPoddoMoMddghcEddghQOcEddcEcEcEghddddcEcEcEghghdd
ddddddddddcEcEddcEcEddcEcEcEddAlAlddddAlAlddAlddAlddAlddAlAlddlglgddoMoMddghghddoMoMddghghddoMoMddghghddoMoMddghghddoMoMddghghddcEcEcEddUWcEddddddcEghFCcEcEghdd
ddddddddddvUvUddbjbjddghghcEddAlAlddAlAlAlAlAlAlAlddAlAlAlAlddlglgddoMoMddcEghddMHoMddghcEddoMoMddghghddoMoMddghcEddoMoMddcEghddcEcEghddghcEghcEcEghcEcEghcEcEdd
ddddddddddddddddddddddcEcEcEddAlAlAlAlloAlddAlddAlddAlAlddAlCOcEcEcEgsgscEcEcEcEgsgscEcEcEcEgsgscEcEcEcEgsgscEcEcEcEgsgscEcEcEddghcEghddcEcEcEcEPdcEcEghcEUWcEdd
ddcEcEghcEghcEghcEcEcEcEcEghddAlAlAlAlAlddddAlAlAlddAlAlAlAlCOcEcEcEcEcEcEcEcEcEcEcEaRcEcEcEcEcEcEcEcEcEcEcEcEcEcEcEcEcEaRcEcEddcEghcEddddcEghFCcEghcEcEcEcEghdd
ddddcEcEghcEcEghcEghcEcEghcEddddAlAlAlddddddAlwDAlddAlddAlAlCOcEcEcEcEcEcEcEcEPocEcEcEcEcEcEcEcEcEcEcEcEaRcEcEuncEcEcEcEcElocEddddUWcEghddddddcEcEghghUWcEghghdd
ddcEcEghcEghcEcEcEghcEghcEghddddddaRddddddddAlAlAlddAlAlAlAlkEcEcEcEcEaRcEcEcElocEcEcEuncEcEcEaRcEcEcEcEcEcEcEcEcEPocEcEcEcEcEddddddghcEcEloddddddddcEcEghghghdd
ddddddddddddddddddddddddddddddddddddddddddddddddddddddddddddddddddddddddddddddddddddddddddddddddddddddddddddddddddddddddddddddddddddcEcEcEcEdddddddddddddddddddd
ddcEcEcEcEcEcEcEcEcEcEcEcEcEcEcEcEcEcEcEcEcEcEcEcEcEcEcEcEcEcEcEcEcEcEcEcEcEcEcEcEcEcEcEcEcEcEcEcEcEcEcEcEcEcEcEcEcEcEcEcEcEcEcEcEcEcEcEcEcEcEcEcEcEcEcEcEcEcEdd
ddcEcEcEcEcEcEcEcEcEcEcEcEcEcEcEcEcEcEcEcEcEcEcEcEcEcEcEcEcEcEcEcEcEcEcEcEcEcEcEcEcEcEcEcEcEcEcEcEcEcEcEcEcEcEcEcEcEcEcEcEcEcEcEcEcEcEcEcEcEcEcEcEcEcEcEcEcEcEdd
ddcEcEcEcEcEcEcEcEcEcEcEcEcEcEcEcEcEcEcEcEcEcEcEcEcEcEcEcEcEcEcEcEcEcEcEcEcEcEcEcEcEcEcEcEcEcEcEcEcEcEcEcEcEcEcEcEcEcEcEcEcEcEcEcEcEcEcEcEcEcEcEcEcEcEcEcEcEcEdd
ddcEcEcEcEcEcEcEcEcEcEcEcEcEcEcEcEcEcEcEcEcEcEcEcEcEcEcEcEcEcEcEcEcEcEcEcEcEcEcEcEcEcEcEcEcEcEcEcEcEcEcEcEcEcEcEcEcEcEcEcEcEcEcEcEcEcEcEcEcEcEcEcEcEcEcEcEcEcEdd
ddcEcEcEcEcEcEcEcEcEcEcEcEcEcEcEcEcEcEcEcEcEcEcEcEcEcEcEcEcEcEcEcEcEcEcEcEcEcEcEcEcEcEcEcEcEcEcEcEcEcEcEcEcEcEcEcEcEcEcEcEcEcEcEcEcEcEcEcEcEcEcEcEcEcEcEcEcEcEdd
ddcEcEcEcEcEcEcEcEcEcEcEcEcEcEcEcEcEcEcEcEcEcEcEcEcEcEcEcEcEcEcEcEcEcEcEcEcEcEcEcEcEcEcEcEcEcEcEcEcEcEcEcEcEcEcEcEcEcEcEcEcEcEcEcEcEcEcEcEcEcEcEcEcEcEcEcEcEcEdd
ddcEcEcEcEcEcEcEcEcEcEcEcEcEcEcEcEcEcEcEcEcEcEcEcEcEcEcEcEcEcEcEcEcEcEcEcEcEcEcEcEcEcEcEcEcEcEcEcEcEcEcEcEcEcEcEcEcEcEcEcEcEcEcEcEcEcEcEcEcEcEcEcEcEcEcEcEcEcEdd
ddcEcEcEcEcEcEcEcEcEcEcEcEcEcEcEcEcEcEcEcEcEcEcEcEcEcEcEcEcEcEcEcEcEcEcEcEcEcEcEcEcEcEcEcEcEcEcEcEcEcEcEcEcEcEcEcEcEcEcEcEcEcEcEcEcEcEcEcEcEcEcEcEcEcEcEcEcEcEdd
ddcEcEcEcEcEcEcEcEcEcEcEcEcEcEcEcEcEcEcEcEcEcEcEcEcEcEcEcEcEcEcEcEcEcEcEcEcEcEcEcEcEcEcEcEcEcEcEcEcEcEcEcEcEcEcEcEcEcEcEcEcEcEcEcEcEcEcEcEcEcEcEcEcEcEcEcEcEcEdd
ddcEcEcEcEcEcEcEcEcEcEcEcEcEcEcEcEcEcEcEcEcEcEcEcEcEcEcEcEcEcEcEcEcEcEcEcEcEcEcEcEcEcEcEcEcEcEcEcEcEcEcEcEcEcEcEcEcEcEcEcEcEcEcEcEcEcEcEcEcEcEcEcEcEcEcEcEcEcEdd
ddcEcEcEcEcEcEcEcEcEcEcEcEcEcEcEcEcEcEcEcEcEcEcEcEcEcEcEcEcEcEcEcEcEcEcEcEcEcEcEcEcEcEcEcEcEcEcEcEcEcEcEcEcEcEcEcEcEcEcEcEcEcEcEcEcEcEcEcEcEcEcEcEcEcEcEcEcEcEdd
ddcEcEcEcEcEcEcEcEcEcEcEcEcEcEcEcEcEcEcEcEcEcEcEcEcEcEcEcEcEcEcEcEcEcEcEcEcEcEcEcEcEcEcEcEcEcEcEcEcEcEcEcEcEcEcEcEcEcEcEcEcEcEcEcEcEcEcEcEcEcEcEcEcEcEcEcEcEcEdd
ddcEcEcEcEcEcEcEcEcEcEcEcEcEcEcEcEcEcEcEcEcEcEcEcEcEcEcEcEcEcEcEcEcEcEcEcEcEcEcEcEcEcEcEcEcEcEcEcEcEcEcEcEcEcEcEcEcEcEcEcEcEcEcEcEcEcEcEcEcEcEcEcEcEcEcEcEcEcEdd
ddcEcEcEcEcEcEcEcEcEcEcEcEcEcEcEcEcEcEcEcEcEcEcEcEcEcEcEcEcEcEcEcEcEcEcEcEcEcEcEcEcEcEcEcEcEcEcEcEcEcEcEcEcEcEcEcEcEcEcEcEcEcEcEcEcEcEcEcEcEcEcEcEcEcEcEcEcEcEdd
ddcEcEcEcEcEcEcEcEcEcEcEcEcEcEcEcEcEcEcEcEcEcEcEcEcEcEcEcEcEcEcEcEcEcEcEcEcEcEcEcEcEcEcEcEcEcEcEcEcEcEcEcEcEcEcEcEcEcEcEcEcEcEcEcEcEcEcEcEcEcEcEcEcEcEcEcEcEcEdd
ddcEcEcEcEcEcEcEcEcEcEcEcEcEcEcEcEcEcEcEcEcEcEcEcEcEcEcEcEcEcEcEcEcEcEcEcEcEcEcEcEcEcEcEcEcEcEcEcEcEcEcEcEcEcEcEcEcEcEcEcEcEcEcEcEcEcEcEcEcEcEcEcEcEcEcEcEcEcEdd
ddcEcEcEcEcEcEcEcEcEcEcEcEcEcEcEcEcEcEcEcEcEcEcEcEcEcEcEcEcEcEcEcEcEcEcEcEcEcEcEcEcEcEcEcEcEcEcEcEcEcEcEcEcEcEcEcEcEcEcEcEcEcEcEcEcEcEcEcEcEcEcEcEcEcEcEcEcEcEdd
ddcEcEcEcEcEcEcEcEcEcEcEcEcEcEcEcEcEcEcEcEcEcEcEcEcEcEcEcEcEcEcEcEcEcEcEcEcEcEcEcEcEcEcEcEcEcEcEcEcEcEcEcEcEcEcEcEcEcEcEcEcEcEcEcEcEcEcEcEcEcEcEcEcEcEcEcEcEcEdd
ddcEcEcEcEcEcEcEcEcEcEcEcEcEcEcEcEcEcEcEcEcEcEcEcEcEcEcEcEcEcEcEcEcEcEcEcEcEcEcEcEcEcEcEcEcEcEcEcEcEcEcEcEcEcEcEcEcEcEcEcEcEcEcEcEcEcEcEcEcEcEcEcEcEcEcEcEcEcEdd
ddcEcEcEcEcEcEcEcEcEcEcEcEcEcEcEcEcEcEcEcEcEcEcEcEcEcEcEcEcEcEcEcEcEcEcEcEcEcEcEcEcEcEcEcEcEcEcEcEcEcEcEcEcEcEcEcEcEcEcEcEcEcEcEcEcEcEcEcEcEcEcEcEcEcEcEcEcEcEdd
ddcEcEcEcEcEcEcEcEcEcEcEcEcEcEcEcEcEcEcEcEcEcEcEcEcEcEcEcEcEcEcEcEcEcEcEcEcEcEcEcEcEcEcEcEcEcEcEcEcEcEcEcEcEcEcEcEcEcEcEcEcEcEcEcEcEcEcEcEcEcEcEcEcEcEcEcEcEcEdd
ddcEcEcEcEcEcEcEcEcEcEcEcEcEcEcEcEcEcEcEcEcEcEcEcEcEcEcEcEcEcEcEcEcEcEcEcEcEcEcEcEcEcEcEcEcEcEcEcEcEcEcEcEcEcEcEcEcEcEcEcEcEcEcEcEcEcEcEcEcEcEcEcEcEcEcEcEcEcEdd
ddcEcEcEcEcEcEcEcEcEcEcEcEcEcEcEcEcEcEcEcEcEcEcEcEcEcEcEcEcEcEcEcEcEcEcEcEcEcEcEcEcEcEcEcEcEcEcEcEcEcEcEcEcEcEcEcEcEcEcEcEcEcEcEcEcEcEcEcEcEcEcEcEcEcEcEcEcEcEdd
ddcEcEcEcEcEcEcEcEcEcEcEcEcEcEcEcEcEcEcEcEcEcEcEcEcEcEcEcEcEcEcEcEcEcEcEcEcEcEcEcEcEcEcEcEcEcEcEcEcEcEcEcEcEcEcEcEcEcEcEcEcEcEcEcEcEcEcEcEcEcEcEcEcEcEcEcEcEcEdd
ddcEcEcEcEcEcEcEcEcEcEcEcEcEcEcEcEcEcEcEcEcEcEcEcEcEcEcEcEcEcEcEcEcEcEcEcEcEcEcEcEcEcEcEcEcEcEcEcEcEcEcEcEcEcEcEcEcEcEcEcEcEcEcEcEcEcEcEcEcEcEcEcEcEcEcEcEcEcEdd
ddcEcEcEcEcEcEcEcEcEcEcEcEcEcEcEcEcEcEcEcEcEcEcEcEcEcEcEcEcEcEcEcEcEcEcEcEcEcEcEcEcEcEcEcEcEcEcEcEcEcEcEcEcEcEcEcEcEcEcEcEcEcEcEcEcEcEcEcEcEcEcEcEcEcEcEcEcEcEdd
ddcEcEcEcEcEcEcEcEcEcEcEcEcEcEcEcEcEcEcEcEcEcEcEcEcEcEcEcEcEcEcEcEcEcEcEcEcEcEcEcEcEcEcEcEcEcEcEcEcEcEcEcEcEcEcEcEcEcEcEcEcEcEcEcEcEcEcEcEcEcEcEcEcEcEcEcEcEcEdd
ddcEcEcEcEcEcEcEcEcEcEcEcEcEcEcEcEcEcEcEcEcEcEcEcEcEcEcEcEcEcEcEcEcEcEcEcEcEcEcEcEcEcEcEcEcEcEcEcEcEcEcEcEcEcEcEcEcEcEcEcEcEcEcEcEcEcEcEcEcEcEcEcEcEcEcEcEcEcEdd
ddcEcEcEcEcEcEcEcEcEcEcEcEcEcEcEcEcEcEcEcEcEcEcEcEcEcEcEcEcEcEcEcEcEcEcEcEcEcEcEcEcEcEcEcEcEcEcEcEcEcEcEcEcEcEcEcEcEcEcEcEcEcEcEcEcEcEcEcEcEcEcEcEcEcEcEcEcEcEdd
ddcEcEcEcEcEcEcEcEcEcEcEcEcEcEcEcEcEcEcEcEcEcEcEcEcEcEcEcEcEcEcEcEcEcEcEcEcEcEcEcEcEcEcEcEcEcEcEcEcEcEcEcEcEcEcEcEcEcEcEcEcEcEcEcEcEcEcEcEcEcEcEcEcEcEcEcEcEcEdd
ddcEcEcEcEcEcEcEcEcEcEcEcEcEcEcEcEcEcEcEcEcEcEcEcEcEcEcEcEcEcEcEcEcEcEcEcEcEcEcEcEcEcEcEcEcEcEcEcEcEcEcEcEcEcEcEcEcEcEcEcEcEcEcEcEcEcEcEcEcEcEcEcEcEcEcEcEcEcEdd
ddcEcEcEcEcEcEcEcEcEcEcEcEcEcEcEcEcEcEcEcEcEcEcEcEcEcEcEcEcEcEcEcEcEcEcEcEcEcEcEcEcEcEcEcEcEcEcEcEcEcEcEcEcEcEcEcEcEcEcEcEcEcEcEcEcEcEcEcEcEcEcEcEcEcEcEcEcEcEdd
ddcEcEcEcEcEcEcEcEcEcEcEcEcEcEcEcEcEcEcEcEcEcEcEcEcEcEcEcEcEcEcEcEcEcEcEcEcEcEcEcEcEcEcEcEcEcEcEcEcEcEcEcEcEcEcEcEcEcEcEcEcEcEcEcEcEcEcEcEcEcEcEcEcEcEcEcEcEcEdd
ddcEcEcEcEcEcEcEcEcEcEcEcEcEcEcEcEcEcEcEcEcEcEcEcEcEcEcEcEcEcEcEcEcEcEcEcEcEcEcEcEcEcEcEcEcEcEcEcEcEcEcEcEcEcEcEcEcEcEcEcEcEcEcEcEcEcEcEcEcEcEcEcEcEcEcEcEcEcEdd
dddddddddddddddddddddddddddddddddddddddddddddddddddddddddddddddddddddddddddddddddddddddddddddddddddddddddddddddddddddddddddddddddddddddddddddddddddddddddddddddd
"}
