"a" = (/turf/unsimulated/wall,/area/space)
"p" = (/turf/space,/area/space)

(1,1,1) = {"
aaaaaaaaaaaaaaaaaaaaaaaaaaaaaaaaaaaaaaaaaaaaaaaaaaaaaaaaaaaaaaaaaaaaaaaaaaaaaaaa
appppppppppppppppppppppppppppppppppppppppppppppppppppppppppppppppppppppppppppppa
appppppppppppppppppppppppppppppppppppppppppppppppppppppppppppppppppppppppppppppa
appppppppppppppppppppppppppppppppppppppppppppppppppppppppppppppppppppppppppppppa
appppppppppppppppppppppppppppppppppppppppppppppppppppppppppppppppppppppppppppppa
appppppppppppppppppppppppppppppppppppppppppppppppppppppppppppppppppppppppppppppa
appppppppppppppppppppppppppppppppppppppppppppppppppppppppppppppppppppppppppppppa
appppppppppppppppppppppppppppppppppppppppppppppppppppppppppppppppppppppppppppppa
appppppppppppppppppppppppppppppppppppppppppppppppppppppppppppppppppppppppppppppa
appppppppppppppppppppppppppppppppppppppppppppppppppppppppppppppppppppppppppppppa
appppppppppppppppppppppppppppppppppppppppppppppppppppppppppppppppppppppppppppppa
appppppppppppppppppppppppppppppppppppppppppppppppppppppppppppppppppppppppppppppa
appppppppppppppppppppppppppppppppppppppppppppppppppppppppppppppppppppppppppppppa
appppppppppppppppppppppppppppppppppppppppppppppppppppppppppppppppppppppppppppppa
appppppppppppppppppppppppppppppppppppppppppppppppppppppppppppppppppppppppppppppa
appppppppppppppppppppppppppppppppppppppppppppppppppppppppppppppppppppppppppppppa
appppppppppppppppppppppppppppppppppppppppppppppppppppppppppppppppppppppppppppppa
appppppppppppppppppppppppppppppppppppppppppppppppppppppppppppppppppppppppppppppa
appppppppppppppppppppppppppppppppppppppppppppppppppppppppppppppppppppppppppppppa
appppppppppppppppppppppppppppppppppppppppppppppppppppppppppppppppppppppppppppppa
appppppppppppppppppppppppppppppppppppppppppppppppppppppppppppppppppppppppppppppa
appppppppppppppppppppppppppppppppppppppppppppppppppppppppppppppppppppppppppppppa
appppppppppppppppppppppppppppppppppppppppppppppppppppppppppppppppppppppppppppppa
appppppppppppppppppppppppppppppppppppppppppppppppppppppppppppppppppppppppppppppa
appppppppppppppppppppppppppppppppppppppppppppppppppppppppppppppppppppppppppppppa
appppppppppppppppppppppppppppppppppppppppppppppppppppppppppppppppppppppppppppppa
appppppppppppppppppppppppppppppppppppppppppppppppppppppppppppppppppppppppppppppa
appppppppppppppppppppppppppppppppppppppppppppppppppppppppppppppppppppppppppppppa
appppppppppppppppppppppppppppppppppppppppppppppppppppppppppppppppppppppppppppppa
appppppppppppppppppppppppppppppppppppppppppppppppppppppppppppppppppppppppppppppa
appppppppppppppppppppppppppppppppppppppppppppppppppppppppppppppppppppppppppppppa
appppppppppppppppppppppppppppppppppppppppppppppppppppppppppppppppppppppppppppppa
appppppppppppppppppppppppppppppppppppppppppppppppppppppppppppppppppppppppppppppa
appppppppppppppppppppppppppppppppppppppppppppppppppppppppppppppppppppppppppppppa
appppppppppppppppppppppppppppppppppppppppppppppppppppppppppppppppppppppppppppppa
appppppppppppppppppppppppppppppppppppppppppppppppppppppppppppppppppppppppppppppa
appppppppppppppppppppppppppppppppppppppppppppppppppppppppppppppppppppppppppppppa
appppppppppppppppppppppppppppppppppppppppppppppppppppppppppppppppppppppppppppppa
appppppppppppppppppppppppppppppppppppppppppppppppppppppppppppppppppppppppppppppa
appppppppppppppppppppppppppppppppppppppppppppppppppppppppppppppppppppppppppppppa
appppppppppppppppppppppppppppppppppppppppppppppppppppppppppppppppppppppppppppppa
appppppppppppppppppppppppppppppppppppppppppppppppppppppppppppppppppppppppppppppa
appppppppppppppppppppppppppppppppppppppppppppppppppppppppppppppppppppppppppppppa
appppppppppppppppppppppppppppppppppppppppppppppppppppppppppppppppppppppppppppppa
appppppppppppppppppppppppppppppppppppppppppppppppppppppppppppppppppppppppppppppa
appppppppppppppppppppppppppppppppppppppppppppppppppppppppppppppppppppppppppppppa
appppppppppppppppppppppppppppppppppppppppppppppppppppppppppppppppppppppppppppppa
appppppppppppppppppppppppppppppppppppppppppppppppppppppppppppppppppppppppppppppa
appppppppppppppppppppppppppppppppppppppppppppppppppppppppppppppppppppppppppppppa
appppppppppppppppppppppppppppppppppppppppppppppppppppppppppppppppppppppppppppppa
appppppppppppppppppppppppppppppppppppppppppppppppppppppppppppppppppppppppppppppa
appppppppppppppppppppppppppppppppppppppppppppppppppppppppppppppppppppppppppppppa
appppppppppppppppppppppppppppppppppppppppppppppppppppppppppppppppppppppppppppppa
appppppppppppppppppppppppppppppppppppppppppppppppppppppppppppppppppppppppppppppa
appppppppppppppppppppppppppppppppppppppppppppppppppppppppppppppppppppppppppppppa
appppppppppppppppppppppppppppppppppppppppppppppppppppppppppppppppppppppppppppppa
appppppppppppppppppppppppppppppppppppppppppppppppppppppppppppppppppppppppppppppa
appppppppppppppppppppppppppppppppppppppppppppppppppppppppppppppppppppppppppppppa
appppppppppppppppppppppppppppppppppppppppppppppppppppppppppppppppppppppppppppppa
appppppppppppppppppppppppppppppppppppppppppppppppppppppppppppppppppppppppppppppa
appppppppppppppppppppppppppppppppppppppppppppppppppppppppppppppppppppppppppppppa
appppppppppppppppppppppppppppppppppppppppppppppppppppppppppppppppppppppppppppppa
appppppppppppppppppppppppppppppppppppppppppppppppppppppppppppppppppppppppppppppa
appppppppppppppppppppppppppppppppppppppppppppppppppppppppppppppppppppppppppppppa
appppppppppppppppppppppppppppppppppppppppppppppppppppppppppppppppppppppppppppppa
appppppppppppppppppppppppppppppppppppppppppppppppppppppppppppppppppppppppppppppa
appppppppppppppppppppppppppppppppppppppppppppppppppppppppppppppppppppppppppppppa
appppppppppppppppppppppppppppppppppppppppppppppppppppppppppppppppppppppppppppppa
appppppppppppppppppppppppppppppppppppppppppppppppppppppppppppppppppppppppppppppa
appppppppppppppppppppppppppppppppppppppppppppppppppppppppppppppppppppppppppppppa
appppppppppppppppppppppppppppppppppppppppppppppppppppppppppppppppppppppppppppppa
appppppppppppppppppppppppppppppppppppppppppppppppppppppppppppppppppppppppppppppa
appppppppppppppppppppppppppppppppppppppppppppppppppppppppppppppppppppppppppppppa
appppppppppppppppppppppppppppppppppppppppppppppppppppppppppppppppppppppppppppppa
appppppppppppppppppppppppppppppppppppppppppppppppppppppppppppppppppppppppppppppa
appppppppppppppppppppppppppppppppppppppppppppppppppppppppppppppppppppppppppppppa
appppppppppppppppppppppppppppppppppppppppppppppppppppppppppppppppppppppppppppppa
appppppppppppppppppppppppppppppppppppppppppppppppppppppppppppppppppppppppppppppa
appppppppppppppppppppppppppppppppppppppppppppppppppppppppppppppppppppppppppppppa
aaaaaaaaaaaaaaaaaaaaaaaaaaaaaaaaaaaaaaaaaaaaaaaaaaaaaaaaaaaaaaaaaaaaaaaaaaaaaaaa
"}
