"aE" = (/obj/machinery/light{dir = 8},/turf/simulated/floor/plasteel{icon_state = "dark"; tag = "icon-dark"},/area/shuttle/abandoned{name = "Torpeda"})
"aF" = (/obj/machinery/power/smes/magical,/turf/simulated/floor/plasteel{icon_state = "dark"; tag = "icon-dark"},/area/shuttle/abandoned{name = "Torpeda"})
"bN" = (/obj/machinery/vending/coffee/free,/turf/unsimulated/floor{dir = 6; icon_state = "darkgreynavyblue"},/area/shuttle/abandoned{name = "Torpeda"})
"bV" = (/obj/machinery/light{dir = 4},/turf/simulated/floor/plasteel{icon_state = "dark"; tag = "icon-dark"},/area/shuttle/abandoned{name = "Torpeda"})
"cf" = (/obj/machinery/vending/boozeomat,/turf/unsimulated/floor{dir = 4; icon_state = "darkgreynavyblue"},/area/shuttle/abandoned{name = "Torpeda"})
"cn" = (/turf/simulated/floor/plasteel{icon_state = "dark"; tag = "icon-dark"},/area/shuttle/abandoned{name = "Torpeda"})
"cK" = (/obj/item/nullrod/claymore/saber/pirate,/obj/item/clothing/gloves/combat,/obj/item/clothing/glasses/eyepatch,/obj/item/clothing/mask/gas/sechailer,/obj/structure/closet/syndicate,/obj/item/implanter/freedom,/obj/item/implanter/adrenalin,/obj/item/radio/headset/syndicate/alt,/obj/item/clothing/suit/space/syndicate/black,/obj/item/clothing/head/helmet/space/syndicate/black,/obj/item/card/id/syndicate/vox,/turf/simulated/floor/plasteel{icon_state = "dark"; tag = "icon-dark"},/area/shuttle/abandoned{name = "Torpeda"})
"cP" = (/obj/machinery/portable_atmospherics/canister/oxygen,/obj/effect/turf_decal/bot_red,/turf/unsimulated/floor{dir = 10; icon_state = "navybluefull"},/area/shuttle/abandoned{name = "Torpeda"})
"de" = (/obj/structure/computerframe,/turf/unsimulated/floor{dir = 5; icon_state = "darkgreynavyblue"},/area/shuttle/abandoned{name = "Torpeda"})
"dr" = (/turf/unsimulated/floor{dir = 1; icon_state = "darkgreynavyblue"},/area/shuttle/abandoned{name = "Torpeda"})
"dw" = (/obj/machinery/light{dir = 4},/obj/machinery/vending/cola/free,/turf/unsimulated/floor{dir = 4; icon_state = "darkgreynavyblue"},/area/shuttle/abandoned{name = "Torpeda"})
"fP" = (/obj/structure/rack{dir = 8; layer = 2.9},/obj/effect/decal/warning_stripes/red/hollow,/obj/item/gun/energy/gun/advtaser{pixel_x = -3; pixel_y = 3},/obj/item/gun/energy/gun/advtaser,/obj/item/gun/energy/gun/advtaser{pixel_x = 3; pixel_y = -3},/obj/effect/turf_decal/bot_red,/obj/item/gun/energy/gun/advtaser{pixel_x = 3; pixel_y = -3},/obj/item/gun/energy/gun/advtaser{pixel_x = 3; pixel_y = -3},/obj/item/gun/energy/gun/advtaser,/obj/item/gun/energy/gun/advtaser,/obj/item/gun/energy/gun/advtaser{pixel_x = -3; pixel_y = 3},/obj/item/gun/energy/gun/advtaser{pixel_x = -3; pixel_y = 3},/obj/item/gun/energy/gun/advtaser,/obj/item/gun/energy/gun/advtaser{pixel_x = 3; pixel_y = -3},/obj/machinery/recharger/wallcharger{pixel_x = 4; pixel_y = 32},/turf/unsimulated/floor{dir = 10; icon_state = "navybluefull"},/area/shuttle/abandoned{name = "Torpeda"})
"fU" = (/obj/structure/mirror/magic{pixel_y = 32},/turf/simulated/floor/plasteel{icon_state = "whiteyellowfull"; tag = "icon-whiteyellowfull"},/area/shuttle/abandoned{name = "Torpeda"})
"gM" = (/obj/structure/AIcore,/turf/unsimulated/floor{dir = 4; icon_state = "darkgreynavyblue"},/area/shuttle/abandoned{name = "Torpeda"})
"gY" = (/obj/structure/closet/secure_closet/guncabinet{anchored = 1; name = "Weapons"; req_access = null},/obj/item/gun/projectile/automatic/pistol/APS,/obj/item/gun/projectile/automatic/pistol/APS,/obj/item/gun/projectile/automatic/pistol/APS,/obj/item/gun/projectile/automatic/pistol/APS,/obj/item/gun/projectile/automatic/pistol/APS,/obj/item/gun/projectile/automatic/pistol/APS,/obj/item/ammo_box/magazine/pistolm9mm,/obj/item/ammo_box/magazine/pistolm9mm,/obj/item/ammo_box/magazine/pistolm9mm,/obj/item/ammo_box/magazine/pistolm9mm,/obj/item/ammo_box/magazine/pistolm9mm,/obj/item/ammo_box/magazine/pistolm9mm,/obj/item/ammo_box/magazine/pistolm9mm,/obj/item/ammo_box/magazine/pistolm9mm,/obj/item/ammo_box/magazine/pistolm9mm,/obj/item/ammo_box/magazine/pistolm9mm,/obj/item/ammo_box/magazine/pistolm9mm,/obj/item/ammo_box/magazine/pistolm9mm,/obj/item/ammo_box/magazine/pistolm9mm,/obj/item/ammo_box/magazine/pistolm9mm,/obj/item/ammo_box/magazine/pistolm9mm,/obj/item/ammo_box/magazine/pistolm9mm,/obj/item/ammo_box/magazine/pistolm9mm,/obj/item/ammo_box/magazine/pistolm9mm,/obj/effect/turf_decal/bot_red,/turf/unsimulated/floor{dir = 10; icon_state = "navybluefull"},/area/shuttle/abandoned{name = "Torpeda"})
"hI" = (/turf/simulated/floor/plasteel{icon_state = "whiteyellowfull"; tag = "icon-whiteyellowfull"},/area/shuttle/abandoned{name = "Torpeda"})
"ip" = (/obj/machinery/optable,/obj/machinery/shower{dir = 8; tag = "icon-shower (WEST)"},/turf/simulated/floor/plasteel{icon_state = "dark"; tag = "icon-dark"},/area/shuttle/abandoned{name = "Torpeda"})
"iD" = (/obj/machinery/light,/obj/structure/mirror/magic{pixel_y = -32},/turf/unsimulated/floor{icon_state = "darkgreynavyblue"},/area/shuttle/abandoned{name = "Torpeda"})
"iJ" = (/obj/machinery/vending/engivend{req_access_txt = null; req_one_access_txt = null},/turf/simulated/floor/plasteel{icon_state = "dark"; tag = "icon-dark"},/area/shuttle/abandoned{name = "Torpeda"})
"ls" = (/obj/effect/decal/warning_stripes/red/hollow,/obj/effect/turf_decal/bot_red,/obj/structure/closet/secure_closet/guncabinet{anchored = 1; name = "Weapons"; req_access = null},/obj/item/gun/projectile/shotgun/automatic/combat,/obj/item/gun/projectile/shotgun/automatic/combat,/obj/item/gun/projectile/shotgun/automatic/combat,/obj/item/gun/projectile/shotgun/automatic/combat,/obj/item/gun/projectile/shotgun/automatic/combat,/obj/item/gun/projectile/shotgun/automatic/combat,/obj/item/gun/projectile/shotgun/automatic/combat,/obj/item/ammo_box/shotgun/buck,/obj/item/ammo_box/shotgun/buck,/obj/item/ammo_box/shotgun/buck,/obj/item/ammo_box/shotgun/buck,/obj/item/ammo_box/shotgun/buck,/obj/item/ammo_box/shotgun/buck,/obj/item/ammo_box/shotgun/buck,/obj/item/ammo_box/shotgun/buck,/obj/item/ammo_box/shotgun/buck,/obj/item/ammo_box/shotgun/buck,/obj/item/ammo_box/shotgun/buck,/obj/item/ammo_box/shotgun/buck,/obj/item/ammo_box/shotgun/buck,/obj/item/ammo_box/shotgun/buck,/obj/item/ammo_box/shotgun/buck,/obj/item/ammo_box/shotgun/buck,/obj/item/ammo_box/shotgun/buck,/obj/machinery/recharger/wallcharger{pixel_x = 4; pixel_y = 32},/turf/unsimulated/floor{dir = 10; icon_state = "navybluefull"},/area/shuttle/abandoned{name = "Torpeda"})
"ma" = (/turf/unsimulated/floor{icon_state = "darkgreynavyblue"},/area/shuttle/abandoned{name = "Torpeda"})
"np" = (/obj/effect/turf_decal/bot_red,/turf/unsimulated/floor{icon_state = "darkgrey"},/area/shuttle/abandoned{name = "Torpeda"})
"nQ" = (/obj/machinery/door/airlock/hatch{req_access_txt = "152"},/turf/simulated/floor/plasteel{icon_state = "dark"; tag = "icon-dark"},/area/shuttle/abandoned{name = "Torpeda"})
"pe" = (/obj/machinery/atmospherics/pipe/simple/hidden{dir = 10; initialize_directions = 10},/turf/unsimulated/floor{dir = 8; icon_state = "darkgreynavyblue"},/area/shuttle/abandoned{name = "Torpeda"})
"pv" = (/obj/machinery/dna_scannernew/upgraded,/turf/simulated/floor/plasteel{icon_state = "dark"; tag = "icon-dark"},/area/shuttle/abandoned{name = "Torpeda"})
"pA" = (/obj/machinery/vending/chinese/free,/turf/simulated/floor/plasteel{icon_state = "dark"; tag = "icon-dark"},/area/shuttle/abandoned{name = "Torpeda"})
"rD" = (/obj/structure/closet/crate,/obj/item/card/emag,/obj/item/storage/toolbox/syndicate,/turf/simulated/floor/plasteel{icon_state = "dark"; tag = "icon-dark"},/area/shuttle/abandoned{name = "Torpeda"})
"rU" = (/turf/unsimulated/floor{dir = 8; icon_state = "darkgreynavybluecorner"},/area/shuttle/abandoned{name = "Torpeda"})
"sG" = (/obj/machinery/porta_turret/syndicate/exterior,/turf/simulated/shuttle{dir = 6; icon_state = "wall3"; tag = "icon-wall3 (SOUTHEAST)"},/area/shuttle/abandoned{name = "Torpeda"})
"sX" = (/turf/simulated/shuttle{dir = 5; icon_state = "wall3"; tag = "icon-wall3 (NORTHEAST)"},/area/shuttle/abandoned{name = "Torpeda"})
"tu" = (/turf/template_noop,/area/template_noop)
"ut" = (/obj/structure/rack{dir = 8; layer = 2.9},/obj/effect/decal/warning_stripes/red/hollow,/obj/item/gun/energy/ionrifle,/obj/item/gun/energy/ionrifle{pixel_x = 4; pixel_y = -4},/obj/effect/turf_decal/bot_red,/obj/machinery/recharger/wallcharger{pixel_x = 4; pixel_y = 32},/turf/unsimulated/floor{dir = 10; icon_state = "navybluefull"},/area/shuttle/abandoned{name = "Torpeda"})
"vi" = (/obj/item/nullrod/claymore/saber/pirate,/obj/item/clothing/gloves/combat,/obj/item/clothing/glasses/thermal/eyepatch,/obj/item/clothing/mask/gas/sechailer,/obj/item/CQC_manual,/obj/structure/closet/syndicate,/obj/item/implanter/freedom,/obj/item/implanter/adrenalin,/obj/item/radio/headset/syndicate/alt,/obj/item/clothing/suit/space/syndicate/black,/obj/item/clothing/head/helmet/space/syndicate/black,/obj/item/card/id/syndicate/vox,/obj/item/storage/box/syndicate,/turf/simulated/floor/plasteel{icon_state = "whiteyellowfull"; tag = "icon-whiteyellowfull"},/area/shuttle/abandoned{name = "Torpeda"})
"vM" = (/obj/machinery/bodyscanner,/turf/simulated/floor/plasteel{icon_state = "dark"; tag = "icon-dark"},/area/shuttle/abandoned{name = "Torpeda"})
"vT" = (/turf/simulated/shuttle/wall{icon_state = "wall3"; tag = "icon-wall3"},/area/shuttle/abandoned{name = "Torpeda"})
"wj" = (/obj/machinery/porta_turret/syndicate/exterior,/turf/simulated/shuttle{dir = 5; icon_state = "wall3"; tag = "icon-wall3 (NORTHEAST)"},/area/shuttle/abandoned{name = "Torpeda"})
"wC" = (/turf/simulated/shuttle{dir = 6; icon_state = "wall3"; tag = "icon-wall3 (SOUTHEAST)"},/area/shuttle/abandoned{name = "Torpeda"})
"xv" = (/obj/machinery/light{dir = 1},/obj/structure/mirror/magic{pixel_y = 32},/turf/unsimulated/floor{dir = 1; icon_state = "darkgreynavyblue"},/area/shuttle/abandoned{name = "Torpeda"})
"ym" = (/turf/unsimulated/floor{dir = 4; icon_state = "darkgreycamo"},/area/shuttle/abandoned{name = "Torpeda"})
"yy" = (/obj/machinery/atmospherics/pipe/simple/hidden{dir = 9},/turf/unsimulated/floor{dir = 8; icon_state = "darkgreycamo"},/area/shuttle/abandoned{name = "Torpeda"})
"Al" = (/obj/machinery/vending/snack/free,/turf/unsimulated/floor{dir = 5; icon_state = "darkgreynavyblue"},/area/shuttle/abandoned{name = "Torpeda"})
"Av" = (/obj/machinery/vending/cigarette/free,/turf/simulated/floor/plasteel{icon_state = "dark"; tag = "icon-dark"},/area/shuttle/abandoned{name = "Torpeda"})
"Dv" = (/obj/structure/shuttle/engine/large{dir = 8},/turf/template_noop,/area/shuttle/abandoned{name = "Torpeda"})
"Ek" = (/obj/structure/dispenser/oxygen,/obj/effect/turf_decal/bot_red,/turf/unsimulated/floor{dir = 10; icon_state = "navybluefull"},/area/shuttle/abandoned{name = "Torpeda"})
"Fh" = (/obj/item/radio/intercom/pirate,/turf/simulated/shuttle/wall{icon_state = "wall3"; tag = "icon-wall3"},/area/shuttle/abandoned{name = "Torpeda"})
"Fq" = (/obj/machinery/light{dir = 8},/obj/machinery/clonepod/upgraded,/turf/simulated/floor/plasteel{icon_state = "dark"; tag = "icon-dark"},/area/shuttle/abandoned{name = "Torpeda"})
"Fz" = (/obj/effect/spawner/window/reinforced,/turf/simulated/floor/plating,/area/shuttle/abandoned{name = "Torpeda"})
"Ge" = (/obj/machinery/sleeper/syndie,/turf/simulated/floor/plasteel{icon_state = "dark"; tag = "icon-dark"},/area/shuttle/abandoned{name = "Torpeda"})
"GO" = (/turf/unsimulated/floor{dir = 10; icon_state = "darkgreynavyblue"},/area/shuttle/abandoned{name = "Torpeda"})
"GQ" = (/obj/structure/shuttle/engine/heater{dir = 8; icon_state = "heater"; tag = "icon-heater (WEST)"},/obj/structure/window/plasmareinforced{dir = 4},/turf/simulated/shuttle/plating,/area/shuttle/abandoned{name = "Torpeda"})
"HR" = (/obj/machinery/computer/cloning,/turf/simulated/floor/plasteel{icon_state = "dark"; tag = "icon-dark"},/area/shuttle/abandoned{name = "Torpeda"})
"HU" = (/obj/machinery/light{dir = 8},/turf/simulated/floor/plasteel{icon_state = "whiteyellowfull"; tag = "icon-whiteyellowfull"},/area/shuttle/abandoned{name = "Torpeda"})
"IF" = (/obj/item/gun/throw/piecannon,/obj/item/gun/throw/piecannon,/obj/item/gun/throw/piecannon,/obj/item/gun/throw/piecannon,/obj/item/gun/throw/piecannon,/obj/item/gun/throw/piecannon,/obj/item/clothing/mask/gas/clown_hat,/obj/item/clothing/mask/gas/clown_hat,/obj/item/clothing/mask/gas/clown_hat,/obj/item/clothing/mask/gas/clown_hat,/obj/item/clothing/mask/gas/clown_hat,/obj/item/clothing/mask/gas/clown_hat,/obj/item/clothing/mask/gas/clown_hat,/obj/item/clothing/shoes/magboots/clown,/obj/item/clothing/shoes/magboots/clown,/obj/item/clothing/shoes/magboots/clown,/obj/item/clothing/shoes/magboots/clown,/obj/item/clothing/shoes/magboots/clown,/obj/item/clothing/shoes/magboots/clown,/obj/item/clothing/shoes/magboots/clown,/obj/structure/closet/syndicate,/obj/item/clothing/under/rank/clown,/obj/item/clothing/under/rank/clown,/obj/item/clothing/under/rank/clown,/obj/item/clothing/under/rank/clown,/obj/item/clothing/under/rank/clown,/obj/item/clothing/under/rank/clown,/obj/item/clothing/under/rank/clown,/turf/simulated/floor/plasteel{icon_state = "dark"; tag = "icon-dark"},/area/shuttle/abandoned{name = "Torpeda"})
"IJ" = (/turf/unsimulated/floor{dir = 9; icon_state = "darkgreynavyblue"},/area/shuttle/abandoned{name = "Torpeda"})
"IT" = (/obj/machinery/light{dir = 4},/obj/structure/rack{dir = 8; layer = 2.9},/obj/item/aicard,/turf/unsimulated/floor{dir = 4; icon_state = "darkgreynavyblue"},/area/shuttle/abandoned{name = "Torpeda"})
"Ks" = (/obj/machinery/computer/shuttle{flags = 512; icon_keyboard = "syndie_key"; icon_screen = "navigation"; name = "\"Torpeda\"Shuttle Console"; possible_destinations = "torpeda_home;torpeda_away"; resistance_flags = 64; shuttleId = "torpeda"},/turf/simulated/floor/plasteel{icon_state = "whiteyellowfull"; tag = "icon-whiteyellowfull"},/area/shuttle/abandoned{name = "Torpeda"})
"Kx" = (/obj/structure/closet/secure_closet/guncabinet{anchored = 1; name = "Weapons"; req_access = null},/obj/item/gun/projectile/automatic/mini_uzi,/obj/item/gun/projectile/automatic/mini_uzi,/obj/item/gun/projectile/automatic/mini_uzi,/obj/item/gun/projectile/automatic/mini_uzi,/obj/item/gun/projectile/automatic/mini_uzi,/obj/item/gun/projectile/automatic/mini_uzi,/obj/item/ammo_box/magazine/uzim9mm,/obj/item/ammo_box/magazine/uzim9mm,/obj/item/ammo_box/magazine/uzim9mm,/obj/item/ammo_box/magazine/uzim9mm,/obj/item/ammo_box/magazine/uzim9mm,/obj/item/ammo_box/magazine/uzim9mm,/obj/item/ammo_box/magazine/uzim9mm,/obj/item/ammo_box/magazine/uzim9mm,/obj/item/ammo_box/magazine/uzim9mm,/obj/item/ammo_box/magazine/uzim9mm,/obj/item/ammo_box/magazine/uzim9mm,/obj/item/ammo_box/magazine/uzim9mm,/obj/item/ammo_box/magazine/uzim9mm,/obj/item/ammo_box/magazine/uzim9mm,/obj/item/ammo_box/magazine/uzim9mm,/obj/item/ammo_box/magazine/uzim9mm,/obj/item/ammo_box/magazine/uzim9mm,/obj/item/ammo_box/magazine/uzim9mm,/obj/effect/turf_decal/bot_red,/turf/unsimulated/floor{dir = 10; icon_state = "navybluefull"},/area/shuttle/abandoned{name = "Torpeda"})
"NQ" = (/obj/structure/chair/comfy/shuttle{dir = 4},/mob/living/carbon/human{faction = list("neutral","syndicate")},/turf/simulated/floor/plasteel{icon_state = "whiteyellowfull"; tag = "icon-whiteyellowfull"},/area/shuttle/abandoned{name = "Torpeda"})
"Ob" = (/obj/machinery/porta_turret/syndicate/exterior,/turf/simulated/shuttle{dir = 9; icon_state = "wall3"; tag = "icon-wall3 (NORTHEAST)"},/area/shuttle/abandoned{name = "Torpeda"})
"OK" = (/obj/machinery/computer/security{network = list("SS13","Mining Outpost")},/turf/unsimulated/floor{dir = 6; icon_state = "darkgreynavyblue"},/area/shuttle/abandoned{name = "Torpeda"})
"OX" = (/obj/machinery/computer/operating,/turf/simulated/floor/plasteel{icon_state = "dark"; tag = "icon-dark"},/area/shuttle/abandoned{name = "Torpeda"})
"PJ" = (/obj/structure/closet/crate/secure/weapon,/obj/item/stack/spacecash/c500,/obj/item/stack/spacecash/c500,/obj/item/stack/spacecash/c500,/obj/item/stack/spacecash/c500,/obj/item/stack/spacecash/c500,/obj/item/stack/spacecash/c500,/obj/item/stack/spacecash/c500,/obj/item/stack/spacecash/c500,/obj/item/stack/spacecash/c500,/obj/item/stack/spacecash/c500,/obj/item/storage/bag/cash,/obj/item/storage/bag/cash,/turf/simulated/floor/plasteel{icon_state = "dark"; tag = "icon-dark"},/area/shuttle/abandoned{name = "Torpeda"})
"Sw" = (/obj/structure/table/glass,/obj/item/storage/toolbox/surgery{pixel_x = -1; pixel_y = 2},/turf/simulated/floor/plasteel{icon_state = "dark"; tag = "icon-dark"},/area/shuttle/abandoned{name = "Torpeda"})
"SL" = (/obj/structure/chair/comfy/shuttle{dir = 4},/turf/unsimulated/floor{dir = 4; icon_state = "darkgreynavybluecorner"},/area/shuttle/abandoned{name = "Torpeda"})
"SQ" = (/obj/structure/closet/crate/secure/weapon,/obj/item/card/emag,/obj/item/storage/toolbox/syndicate,/obj/item/storage/box/syndicate,/turf/simulated/floor/plasteel{icon_state = "dark"; tag = "icon-dark"},/area/shuttle/abandoned{name = "Torpeda"})
"SU" = (/turf/unsimulated/floor{dir = 1; icon_state = "darkgreynavybluecorner"},/area/shuttle/abandoned{name = "Torpeda"})
"To" = (/obj/structure/closet/secure_closet/medical2,/turf/simulated/floor/plasteel{icon_state = "dark"; tag = "icon-dark"},/area/shuttle/abandoned{name = "Torpeda"})
"TH" = (/obj/effect/spawner/airlock/e_to_w/long/square/wide,/turf/simulated/shuttle/wall{icon_state = "wall3"; tag = "icon-wall3"},/area/shuttle/abandoned{name = "Torpeda"})
"Uk" = (/obj/structure/chair/comfy/shuttle{dir = 4},/turf/unsimulated/floor{icon_state = "darkgreynavybluecorner"},/area/shuttle/abandoned{name = "Torpeda"})
"Vw" = (/obj/structure/chair/comfy/shuttle{dir = 4},/obj/effect/turf_decal/bot_white,/mob/living/carbon/human{faction = list("neutral","syndicate")},/turf/unsimulated/floor{icon_state = "darkgrey"},/area/shuttle/abandoned{name = "Torpeda"})
"VD" = (/obj/machinery/vending/medical{req_access_txt = null; req_one_access_txt = null},/turf/simulated/floor/plasteel{icon_state = "dark"; tag = "icon-dark"},/area/shuttle/abandoned{name = "Torpeda"})
"VH" = (/turf/template_noop,/area/shuttle/abandoned{name = "Torpeda"})
"Wb" = (/obj/effect/decal/warning_stripes/red/hollow,/obj/effect/turf_decal/bot_red,/obj/item/ammo_box/magazine/laser,/obj/item/ammo_box/magazine/laser,/obj/item/ammo_box/magazine/laser,/obj/item/ammo_box/magazine/laser,/obj/item/ammo_box/magazine/laser,/obj/item/ammo_box/magazine/laser,/obj/item/ammo_box/magazine/laser,/obj/item/ammo_box/magazine/laser,/obj/item/ammo_box/magazine/laser,/obj/item/ammo_box/magazine/laser,/obj/item/ammo_box/magazine/laser,/obj/item/ammo_box/magazine/laser,/obj/item/ammo_box/magazine/laser,/obj/item/ammo_box/magazine/laser,/obj/item/ammo_box/magazine/laser,/obj/item/ammo_box/magazine/laser,/obj/item/ammo_box/magazine/laser,/obj/item/ammo_box/magazine/laser,/obj/item/ammo_box/magazine/laser,/obj/item/ammo_box/magazine/laser,/obj/structure/closet/secure_closet/guncabinet{anchored = 1; name = "Weapons"; req_access = null},/obj/item/gun/projectile/automatic/lasercarbine,/obj/item/gun/projectile/automatic/lasercarbine,/obj/item/gun/projectile/automatic/lasercarbine,/obj/item/gun/projectile/automatic/lasercarbine,/obj/item/gun/projectile/automatic/lasercarbine,/obj/item/gun/projectile/automatic/lasercarbine,/obj/item/gun/projectile/automatic/lasercarbine,/obj/machinery/recharger/wallcharger{pixel_x = 4; pixel_y = 32},/turf/unsimulated/floor{dir = 10; icon_state = "navybluefull"},/area/shuttle/abandoned{name = "Torpeda"})
"WU" = (/turf/simulated/shuttle/plating,/area/shuttle/abandoned{name = "Torpeda"})
"WZ" = (/turf/unsimulated/floor{dir = 8; icon_state = "darkgreynavyblue"},/area/shuttle/abandoned{name = "Torpeda"})
"XQ" = (/obj/structure/table/reinforced,/obj/machinery/recharger,/obj/item/gun/energy/laser/retro,/turf/simulated/floor/plasteel{icon_state = "whiteyellowfull"; tag = "icon-whiteyellowfull"},/area/shuttle/abandoned{name = "Torpeda"})
"YS" = (/obj/machinery/atmospherics/unary/tank/air{dir = 4},/turf/simulated/shuttle/wall{icon_state = "wall3"; tag = "icon-wall3"},/area/shuttle/abandoned{name = "Torpeda"})
"Zg" = (/obj/machinery/porta_turret/syndicate/exterior,/turf/simulated/shuttle{dir = 10; icon_state = "wall3"; tag = "icon-wall3 (NORTHEAST)"},/area/shuttle/abandoned{name = "Torpeda"})
"Zm" = (/obj/docking_port/mobile{dheight = 2; dir = 4; dwidth = 8; height = 23; id = "torpeda"; name = "Torpeda shuttle"; roundstart_move = "torpeda_home"; width = 17},/obj/docking_port/stationary{dheight = 2; dir = 4; dwidth = 8; height = 23; id = "torpeda_home"; name = "Torpeda Home"; width = 17},/turf/simulated/floor/plasteel{icon_state = "dark"; tag = "icon-dark"},/area/shuttle/abandoned{name = "Torpeda"})
"ZP" = (/turf/unsimulated/floor{icon_state = "darkgrey"},/area/shuttle/abandoned{name = "Torpeda"})
"ZU" = (/obj/machinery/light{dir = 8},/obj/structure/bed,/obj/item/bedsheet/fluff/hugosheet,/turf/simulated/floor/plasteel{icon_state = "whiteyellowfull"; tag = "icon-whiteyellowfull"},/area/shuttle/abandoned{name = "Torpeda"})
"ZZ" = (/obj/machinery/vending/tool{req_access_txt = null; req_one_access_txt = null},/turf/simulated/floor/plasteel{icon_state = "dark"; tag = "icon-dark"},/area/shuttle/abandoned{name = "Torpeda"})

(1,1,1) = {"
ObvTvTvTvTvTvTsXtututusXtututututututututututu
VHWUGQPJcKcKcKvTwjtutuvTwjtutututututututututu
DvWUGQPJcncncnvTvTvTvTvTvTsXtutusXtutututututu
VHWUGQPJcncncnvTfPlsWbutvTvTwjtuvTwjtututututu
DvWUGQcnbVvTnQvTIJdrdrdrAlvTvTvTvTvTsXtutututu
ZgvTvTiJZZFzIJxvSUZPZPZPSLdevTpvcnVDvTwjtututu
tuZgvTvTFzFhWZZPVwZPVwZPZPgMFhHRcncnvTvTvTvTsX
tutuvTcncnYSpeZPZPZPZPZPZPITvTFqcnGeFhZUfUXQFz
tutuZmcncncnyyZPVwZPVwZPnpymnQcncncnnQhINQKsFz
tutuvTcncnvTWZZPZPZPZPZPZPdwvTaEcnvMFhHUhIviFz
tuObTHvTFzFhWZZPVwZPVwZPZPcfFhcncnipvTvTvTvTwC
ObvTvTaFIFFzGOiDrUZPZPZPUkOKvTToSwOXvTsGtututu
VHWUGQAvbVvTnQvTGOmamamabNvTvTvTvTvTwCtutututu
DvWUGQpAcncncnvTcPKxgYEkvTvTsGtuvTsGtututututu
VHWUGQrDcncncnvTvTvTvTvTvTwCtutuwCtutututututu
DvWUGQSQcKcKcKvTsGtutuvTsGtutututututututututu
ZgvTvTvTvTvTvTwCtututuwCtututututututututututu
"}
